111111111
1000X1111
11PCE1111
111111111