1111111111111
10P0000C00111
1010000101111
1000C000000C1
100C000000001
1110011111111
1000010100111
10000000C0111
10100C0101111
1000C00000001
10000000C00E1
1111111111111