1111111111111
10P00000P0111
1010000101111
1000000000001
1000000000001
1110011111111
1000010100111
1000000000111
1010000101111
1000000000001
1000000000001
1111111111111