11111111111111
10101010101011
10101P10111011
11111111111111