111111111111111111111111111111111111111111111111111
1CE000111111111111111111111111111111111111111111111
100000011111111111111111111111111111111111111111111
100000011111111111111111111111111111111111111111111
100000011111111111111111111111111111111111111111111
100000011111111111111111111111111111111111111111111
100000011111111111111111111111111111111111111111111
100000011111111111111111111111111111111111111111111
100000011111111111111111111111111111111111111111111
100000011111111111111111111111111111111111111111111
100000011111111111111111111111111111111111111111111
100000011111111111111111111111111111111111111111111
100000011111111111111111111111111111111111111111111
100000011111111111111111111111111111111111111111111
100000011111111111111111111111111111111111111111111
100000011111111111111111111111111111111111111111111
100000011111111111111111111111111111111111111111111
100000011111111111111111111111111111111111111111111
100000011111111111111111111111111111111111111111111
100000011111111111111111111111111111111111111111111
100000011111111111111111111111111111111111111111111
100000011111111111111111111111111111111111111111111
100000011111111111111111111111111111111111111111111
100000011111111111111111111111111111111111111111111
100000011111111111111111111111111111111111111111111
100000011111111111111111111111111111111111111111111
110101P11111111111111111111111111111111111111111111
111111111111111111111111111111111111111111111111111