1 1 1 1 1 1 1 1 1 1
1 0 0 0  0 0 0 0 1
1 0 1 1 1 1 1 1 0 1
1 0 1 0 0 0 0 1 0 1
1 0 1 0 1 1 0 1 0 1
1 0 0 0 0 1 0 1 0 1
1 0 1 1 0 1 0 1 0 1
1 0 1 0 0 0 0 1 0 1
1 0 0 0 c c 1 1 0 1
1 1 1 1 1 1 1 1 1 1
